"ZONE 26"
117 levels by Dries De Clercq

AuthorName: Dries De Clercq <de3s@hotmail.com>
AuthorPage: http://www.freewebs.com/dries/soko.htm
LevelsLink: http://www.freewebs.com/dries/images/zone26.zip (xsb)
            http://www.freewebs.com/dries/images/zone26.txt

A huge collection where all levels have a floor size of 26 squares.
Most of these levels are quite difficult !

Author:Dries De Clercq
Title: Zone26


 ####
 # .####
##.    #
#.. ## #
# # ## #
# $  $ #
## $$###
 #@  #
 #####
Title: Islands

 #######
 #     #
##. ## #
# .$+# #
#  $*# #
### $  #
  #  ###
  #  #
  ####
Title: Logical

 #####
 #   #
 #$# ###
 #  $  #
## . ..#
# $##. #
#@$   ##
####  #
   ####
Title: Fluently

   ####
   #  #
   # .#
####  ###
# .  .. #
# $#$$  #
##@$ # ##
 ###   #
   #####
Title: 4 2 die 4

 ######
 #.   #
## ## #
# ..$ ##
#   #$ #
# .$ $@#
##  ####
 #  #
 ####
Title: Soko-San

 ####
 #  ####
 #$  $ #
 # . . #
##$##. #
#  .# ##
#  $  #
#### @#
   ####
Title: Go Round 1

 #####
 #   #
 # #$#
 # $@###
## #$  #
#  . . #
#  .#$ #
###  .##
  #####
Title: Stock

 ####
 #  ####
 #$  $ #
 # . . #
##$##. #
# @#. ##
# $   #
####  #
   ####
Title: Go Round 2

  #####
###   #
# $$# ##
# $ .. #
# # .. #
# #$$  #
#. @####
#####
Title: Excluded

#######
#     #
# #.# #
# $ $ #
## ** #
 #@#. #
 # $  #
 ### .#
   ####
Title: Collider

 #####
##  .###
#@*  $ #
# #$. .#
#   #$.#
###$#  #
  #    #
  ######
Title: 5 To Go

   #####
####  .#
#@$.$# #
#$#.  .#
#.   # #
#  $ $ #
#  #####
####
Title: Pillars

######
#  . ###
# # $  #
#  . # #
##. $$.#
 #$# $ #
 #+  ###
 #####
Title: Socialising

######
#    #
#.#$ #
# #. ###
#.$  $ #
# # **@#
#     ##
#######
Title: The Door

  ####
 ##  ##
 #  *+#
## # $#
# $ * #
# # $ #
#.  . #
###   #
  #####
Title: The Fly

#######
#     #
# # . #
#   $ #
## #* #
 #$#. #
 #  $*#
 ###@.#
   ####
Title: Prairie Dog

   ####
#### @#
# $ *$#
#  #  ##
#  $*  #
# .. # #
###   .#
  ######
Title: Order

  ####
  #  #
###  #
#  *+#
# # $###
# $.*  ##
##   $  #
 #### . #
    #####
Title: Closing

#####
#   ####
# $  $ #
##..$ .#
#  #.$ #
#   *@##
####  #
   ####
Title: Preparation

######
#   .#
# $# ##
##@$. #
##$*  #
# . . #
# $  ##
#  ###
####
Title: Escape From Alcatraz

#######
#+    ##
#   $$ #
#.#$   #
#.#  $ #
#.#$####
#.  #
#####
Title: Rotating Block

####
#  ####
# .@  #
#$ #$ #
# $  ##
#.*.$#
# #  #
#  . #
######
Title: Thinking Process

 #######
 #     #
##$ ##.#
# $  #.#
#@$$  .#
##  $..#
 #  ####
 ####
Title: Picky

 #####
 #   #
 # $$#
 # $@#
## #$###
#..  $ #
# .. . #
##   ###
 #####
Title: Sokogravity 1

#####
#   ###
# #*  ##
#   .  #
###$ * #
  #@$. #
  #$# ##
  #.  #
  #####
Title: My Chain For You

 #####
 # . #
 #$. ##
 # .. #
 #$$  #
##@# ##
# $$  #
#   . #
#######
Title: Not Too Far

 ####
 #@ ###
 #$$  #
 # $  #
## #.###
#.  .  #
# $. * #
#####  #
    ####
Title: Breakpoint

########
#  . *@#
#  *$. #
## * $ #
#  # ###
#    #
#  ###
####
Title: Arranged

  #####
  #   #
 ##  $##
 #  .$@#
##.#$# #
#  $.*.#
#    ###
###  #
  ####
Title: 2-3-2

  ####
  # @#
  # $###
###*   #
# .  # #
# $$.. #
# .$# ##
###   #
  #####
Title: Reach Out

  ####
 ##  #
## . ###
#@$.$  #
# $$ # #
##  . .#
 # #$###
 #  .#
 #####
Title: Look At That !

  ####
  # @#
### $###
#  $. .#
# $* # #
## . # #
 # .$  #
 ##  ###
  ####
Title: Intersection

   ####
   #  #
 ###  ##
 #@$   #
##$# $ #
#..$$# #
#.     #
#..#####
####
Title: Classic Sokoban

 #####
 #   #
 # # ###
 #. $  #
 # #.* #
##*@$ ##
#  *  #
#   ###
#####
Title: Checkery

  ######
###  . #
#  $#  #
#  * . #
##$# * #
 # @$  #
 ####. #
    ####
Title: Pinball

  #####
  #   #
  #$$ #
  #@$ #
###$# #
# $   ##
# . .. #
### .. #
  ######
Title: Sokogravity 2

  ####
  #  #
###+$###
# $$.  #
#    # #
###*. .#
  # #$ #
  #    #
  ######
Title: Know How

 #####
 #.  #
## #$###
# . .$ #
#  .   #
# #$ ###
#. $$#
###@ #
  ####
Title: Many Ways

####
#  #
#+ #####
#$$    #
#..*$  #
#. $ ###
# ## #
#    #
######
Title: Strucked Down

  ####
 ## .###
 #  $@.#
##* $. #
# . # ##
#  $$ #
# # ###
#   #
#####
Title: Obstacles

 #######
 # .$  #
##$    #
#@ $ ###
# #. #
#.*. #
## #$#
 #   #
 #####
Title: Addition

#####
#   ###
# .$ .##
# $ #$ #
#$.    #
#  #$###
#..@ #
######
Title: Structural

  #####
  #   #
###.$.##
#. $$  #
# ##.  #
#   *@##
### $ #
  #  ##
  ####
Title: Shelter

  #####
  #   #
###*  ##
#  .$.@#
# $#.  #
##  * ##
 ## $ #
  #  ##
  ####
Title: Round and round

########
#   $ .#
# . . .#
#  $ # #
## # $ #
 #$#$###
 #.@ #
 #####
Title: S

  #####
 ##   #
 #    #
 #* .##
 #. ##
##* #
#@$ #
#$ $#
#.  #
#   #
#####
Title: Worm

   ####
  ##  #
### * #
#.  * ##
# # *  #
# $$@ .#
###   ##
  #  ##
  ####
Title: Fragile

  #####
  #   ##
  #$#  #
  #    #
  # . ##
###$* #
# @ *$#
# ..  #
#######
Title: 90°

  ####
  #  #
  # .##
### * ###
#@.$$   #
# $     #
####$#.##
   #  .#
   #####
Title: Continue

  ####
  #  ###
  # $ @#
  # $..#
### $#.#
#. $.$ #
# #   ##
#   ###
#####
Title: Addition

 ####
 # @#
 # $#
##$.#
# $ #
# . ###
#.. $ #
#     #
##.$###
 #  #
 ####
Title: The Root

    ####
  ### @#
 ##. *$#
##  #* #
# .    #
#  $ $ #
##### .#
    #  #
    ####
Title: The sledge

 ####
 # @#
##$$###
# .$ .#
# . # ##
# *$   #
## #   #
 #.  ###
 #####
Title: 75 Pieces Of A Cake

  ####
  # .###
### .  #
# $ $  #
#   #.##
### $$ #
  #  $+#
  # .###
  ####
Title: Heart

  ####
  #  #
### .##
#  $  ###
#  ...  #
### $ * #
  #$#$###
  # @ #
  #####
Title: Wall 3.5 Beta

  ####
  #@ #
###*$###
#  $ $ #
#. ..  #
# #  ###
#.# $#
#    #
######
Title: Epicenter

 ####
 #+ #
##$ #####
# .$  $ #
#  $    #
##. #####
 #* #
 #. #
 #  #
 ####
Title: X

 ####
 #  ####
## +   #
# $$   #
# .$#.$#
### * .#
  #  ###
  #  #
  ####
Title: Switch 2

 #####
## . ##
#     #
# .$.*##
## #$  #
 #  $. #
 ### $##
   # @#
   ####
Title: The 5 Elements

####
#  #####
# $    #
#      #
###$#$##
  # .* #
  # .*@#
  # .###
  ####
Title: ER

  ####
  #  ##
  # . #
###$* ###
#   *  .#
# @$  $ #
###### .#
     #  #
     ####
Title: Easy 83

  ####
###  #
#  $ ###
#..*$ @#
#   .$ #
# .# ###
##$# #
 #   #
 #####
Title: 85

 ####
 #  ###
 #  $ #
##$$@.#
#  #$.#
#. .$.#
#   $##
## . #
 #####
Title: Explosive

 #####
##   ##
# ..  #
# *. $##
# .#   #
##$$$$ #
 #. @###
 #####
Title: The cage

   #####
####   #
#    $ #
# .*$+##
##$.$$ #
 #.  . #
 ####  #
    ####
Title: Stage 1

#####
#   ####
#    * #
##.*$$@#
##$ . ##
#  .* #
#   ###
#####
Title: Stage 2

  ####
###  ##
# .  @##
# * *$ #
# *$.# #
#  $.  #
###  ###
  ####
Title: Love Lines

#######
#     #
#...$ ##
#  $$  #
###+$# #
  #* * #
  #   ##
  #####
Title: The Eating Horse

 ####
 # @###
 #**. #
 # $  #
##.#  #
#   $ #
#..$$##
#    #
######
Title: Co-existence

####
#  ###
#.  .###
# $#$ @#
# $.** #
#    $ #
## . ###
 #####
Title: Usual

 ####
##@ ###
# **  ##
#  **. #
# * $  #
##   ###
 ##  #
  #  #
  ####
Title: Melting

   ####
  ##  #
  #   ##
 ## ** #
## ..  #
# $ $$.#
# .$@###
#  ###
####
Title: Candidates

 ####
 #@ ##
 # * #
##$. #
#  .$##
#*$   #
# . * #
#    ##
######
Title: Sequence

  #####
  #   ##
### .  #
#  $ #.#
# $@*$ #
###**. #
  #    #
  ######
Title: Guilty Pleasures

####
#@ ###
# $ .#
# * $##
##* * #
 # .* ##
 #     #
 ###   #
   #####
Title: The Passage

#######
# + . ##
#   *$ #
###$.  #
  #  * #
  #$#$ #
  #  . #
  ######
Title: Pinguin

 #####
##   ###
# $#   #
# .*$..#
# $  @ #
## *$###
 # . #
 #####
Title: The Art Of Symmetry

####
#  ####
#  *  #
# $  .#
## *# #
 #  * #
 # $.$#
 ## .@#
  #####
Title: Magnetic

   ####
   #  #
####  ##
#   $. #
#  **  #
# $+$# #
## * . #
 #######
Title: Wicked Warehouse

  #####
###   #
#.*.. #
#  $* #
#.#   #
#   $ #
###$$##
  # @#
  ####
Title: Lost in magic

#####
#.  ###
# #$  #
#  . .##
#.* *$ #
#  $ $@#
####  ##
   ####
Title: Till The End

 ######
 #    #
 #$*$.#
 #  #.#
## *@ #
#  *. #
# $  ##
#  ###
####
Title: Peninsula

  ####
###. #
# $  #
#  $ ###
#..#   #
#@*.$$ #
## *   #
 #######
Title: Spiral

   #####
   #@  #
####$$ #
#   .$ #
# .$# .#
##$ .* #
 # .  ##
 ######
Title: Immobile

#####
# . ####
#    $@#
##$ *$*#
 # # * #
 # . . #
 ###   #
   #####
Title: +.

  ####
  #  #
###  ###
#  *$$@#
# #  *$#
#. ..$.#
##     #
 #######
Title: With Honor

  ####
  #  ##
###.$ ##
#  * $ #
# $ *$@#
# # . ##
# . . #
#######
Title: Organised chaos
#####
# + ##
#$ $ ###
# *..  #
# $ $  #
#.$# ###
# .  #
######
Title: Y .

####
#  ##
#.$ #####
#  ..   #
## $ $  #
 #$*. ###
 #@*  #
 ######
Title: Traffic

#######
#   $.##
#. $  +#
####$.$#
   # * #
   # * #
   #   #
   #   #
   #####
Title: In The Line

  ####
  #  #
###  #
#  * #
#. . #
# $.$##
##$*$ #
 #  .@#
 ###  #
   ####
Title: Pacman

 #######
 # * . #
 # .   #
 # .$###
##$. #
#. $$#
#  $@#
#  ###
####
Title: 1 for 1

  ####
###  #
# $$ ##
# *   #
# .$# ##
#@*.*  #
##   . #
 #######
Title: Cosy

######
# *  #
# ..$###
#  $   #
##..$  #
# $$ ###
#  +##
#####
Title: abf

  ####
  # @#
  #$$#
  # .###
###$.. #
# $ $  #
#  *. ##
#    .#
#######
Title: Divided in 3

  #####
  # @.#
  # .$#
  # * #
 ##$* ##
##  $  #
#  *.  #
#   ####
#####
Title: Not just yet

   ####
   #  #
####$.##
# $    #
#@.**. #
#$$    #
#. #####
#  #
####
Title: The Center

  ####
  #  #
### $###
#  $. .#
# . .  #
###$* $#
  #@*  #
  ###  #
    ####
Title: The Iron Curtain

  ####
  #  ###
  # . .#
### ** #
# @$$. #
# $  $ #
#####. #
    #  #
    ####
Title: Rotation

   #####
 ###   #
##   $ #
# $.* ##
#..$. #
#   .##
###$$#
  # @#
  ####
Title: ?

   ####
  ##  #
### . #
# $ $.#
#.*   #
#   * #
###.$##
  #$ #
  #@ #
  ####
Title: Elevators 1

####
#@ #####
#.$ .  #
# $*.* #
## $  ##
 # $ ##
 # . #
 #  ##
 ####
Title: South-America

   #####
####.  #
# +$.$ #
# $ ..##
###$$ #
  # $.#
  #   #
  #   #
  #####
Title: Into the deep

####
#  ###
# $  #
#  .$###
##$.$.@#
 #.  $ #
 # * ###
 # . #
 #####
Title: Shrinking

  ####
  # @###
  #$$  #
 ##.*  #
 # * *##
## *. #
#     #
#   ###
#####
Title: Pacman 2

####
#  ##
# . ###
#   $ #
##.$..#
 # *$@#
 # .$ #
 # $###
 #  #
 ####
Title: Complex switches

 ####
 #  #
## $####
# .  $@#
#  ** .#
# * *  #
###  ###
  #  #
  ####
Title: Birdie

  ####
  #  #
###  ###
# $. $ #
#  * . #
# $* ###
## .$#
 # .@#
 #####
Title: Crashing Birdie

  ####
###@ #
#. $$#
#. * ###
##$.$. #
 # *   #
 #   ###
 #   #
 #####
Title: Divided in 5

 ####
 #  #
 #. #
 #$ #
##. ####
# * $@ #
# *$*  #
#   .  #
########
Title: Bigfoot

  ####
  #  ##
### . #
# $*  ##
#.. .$ #
# $* $@#
###  ###
  #  #
  ####
Title: Extension

   #####
 ### . #
## $   #
# .  *##
#   * #
###.$ #
  #$* #
  # @##
  ####
Title: Tension

  ####
  #  ###
  #$   #
  # . .#
###$. ##
#  $* #
#@* .$#
###   #
  #####
Title: The Big Center

  ####
  #  #
###  ###
#@$  $ #
#.**$..#
#  $   #
#. #####
#  #
####
Title: The Passage

####
#  #
#  ###
# $  ##
#. ** #
# $.*@#
##   ##
 # * #
 #  ##
 ####
Title: Blockie

  ######
  #  * #
###.*  ##
#  * .  #
#  $.$  #
### $####
  #@ #
  ####
Title: Godlike

####
#  ####
#  $  #
#.$.. #
# * $.#
#$ *$ #
#  .@##
######
Title: T-time


