The YASGen Collection
Copyright (c) 2003 Brian Damgaard

Mythology information:

Microsoft(r) Encarta(r) Encyclopedia 2000
Copyright (c) 1993-1999 Microsoft Corporation.

The 1995 Grolier Multimedia Encyclopedia
Copyright (c) 1995 Grolier Electronic Publishing, Inc.

Wikipedia, the free encyclopedia.


Macros

Author=Author: YASGen & Brian Damgaard\n\nThese levels may be freely distributed provided they remain unchanged and credited with the author's name.

Author:Brian Damgaard
Title: YASGen

"YASGen 1", by Brian Damgaard

#########
#  # ...#
#  $$#..#
#  $  *.#
##   $$$#
#     #@#
#########

<#Author#/>

Solution/Moves (Built-in)
UULuullDDuurrddLruulldLDlddrUdrrULdlluuluurDDurrDLruurrddLddllURUrruul
lDlDRlulldRurrdddllUUluRdddrruuLruurrddLLddrUluuurrddrdLuuurDlullddRld
drUrUUruLdddlluRdrUUddldllluRlURRRdrUdrUUddlldlUluRRRdrUlllllluurDldRR
RRRlluLdlluurDldRRRR


"YASGen 2", by Brian Damgaard

 ########
##@$ .. #
# $#$ *.#
#  $  *.#
# $  #.$#
##  # . #
 #      #
 ########

<#Author#/>

Solution/Moves (Built-in)
DlddRluurDDuRRdLuluuRRDrRDrDuluurDlllullddrdrUlluurrRdrdLLLrruulDrrruL
ddlLdlddrrruUrULLruurDllluRdrddddllluurUruullldlddRURRdLddrrruuuululll
DlddRluururrrdrruLLrdddddllluUruRldlddrrruuUlldllluurDRRRuurrdLDDrUlll
dlddrrrrUUlullllldRurDrurruulLDurrdddrddlllllUUruRRluurrdDlldllluRRdrU
lluuRRRllldddddrUUluRRRlUdlluurRdR

Solution/Pushes (Built-in)
DlddRluurDDuRRdLuluuRRDrRDrDuluurDllluRlllddrdrUlluurrrdrdLLLrruulDrdL
rruruLddlldlddrrruUrULuurDllluRllldlddRluurDRluurrrdrddddllluUrULdddrr
ruuuulullldlddRluururrrdrruLLrdddddllluUruRldlddrrruuUlldllluurDRRRuur
rdLDDrUlllldddrrrrUUluuulLDurrdddrddlllluuulldRurRuurrdddrddlllluUruRl
uurrdDlldlluRRRluRldlluuRRRddldlddlUUluRRdrUUdlluurR


"YASGen 3", by Brian Damgaard

#########
#   . $ #
# $ ***@#
##   .$ #
#####. ##
#    *  #
#  $ .  #
#########

<#Author#/>

Solution/Moves (Built-in)
uLLDDlluulldRdrrruurrddLddLdlLulldRRRRuLLrrruuruullLLDRdRDrdLuuluurDll
lluRRdrrurrdLDuLLdRdddlluRdrUrrdLLuUUluRurrddLDlUrruulDDlluLulldRdRluu
rRRldLrRdrruLLddddrruLdlUlldRRurUUlDuuullddRluurrdDrruuLLddlluRlulldRR
drrrddLUddlluRdrUrrdLulldllluRRR


"YASGen 4", by Brian Damgaard

 ########
##      #
#@$ $*  #
##$$ * ##
# $...###
# # *$  #
#  ...  #
#########

<#Author#/>

Solution/Moves (Built-in)
RurrDRDululldRDRdDlUddlluuRURuurrdLDururrdLdLruulldRlullDRdDllddrrUrRU
ULDLddlluuRURuurrDLDururrdLdLruulldRddddLLuURlddrruLulllddRRUruUruulll
DDRRddlUddlluuRuRDluuurDurrdLDururrdLdLruulldRlulldRlddrUdDrrUULDlluRl
uurDDuurrDLDururrdLdLLuRddddrruLdlUUUluurDDDDuuuurrdLulDDluulldRRlldRR

Solution/Pushes (Built-in)
RurrDRlulldRDuurrdDuullddRdDRllUddlluuRURldlddrruruLuuulDrurrdLDururrd
LdLruulldRlulldRdddrrUULDlddlluuRURuurrDLrurrdLulldDuurrddLdddLLrruuur
uulldRddddlluURlddrruLulllddRRUruUruulllDDRRddlUddlluuRuRDDuluuurDurrd
LDururrdLdLruulldRlulldddrdrrUUddlluluuRlddrUddrruuLDlluuurrrDurrdLull
DDuurrddLruulldRddLruulDrdddrruLdlUUUluurDDDDuuuurrdLulDDluullddRRlluR
R


"YASGen 5", by Brian Damgaard

  #######
  # . $@#
 ## .$$##
 # $.$ ##
##...#  #
#  $.$$ #
#  $..  #
#########

<#Author#/>

Solution/Moves 300/95
LDLLddddrrruulDLdlLUlldRRuRuuurrDDrddLULLuuurrdDrdLuuulldRlddLdlluRuuR
RddLruulldRddlUruuruulDDrurrDDrddlULLLdlluRRRUUlDrdLuuuurDDurruLrddDrd
dlUUULulldddrRlluuurrdLulDrrrdrddlUllldlluRRRUUllDRddlUruurrrDrddlULLL
uurrrDrdLuuluurDDllluRdldddlluRdrUrUUllDRddlUruurrruulDrdDrddlULLLdllu
RdrUrrrUULuurDDDrdLL


"YASGen 6", by Brian Damgaard

#########
#  #....#
#   @#**#
# $$# ..#
##  $$ *#
 #$ $   #
 #      #
 ########

<#Author#/>

Solution/Moves (Built-in)
lDDlUrururrDDlDLrurrDLddllURdlllURUUlluurDldRDrddrruLrdrrULLruulDrddll
llUUrRRurDllllddrUluUluurDDDRRRuruulldLDlluurDldRdRddlUUUluurDrDDlUrur
urrddldLrurrDLuuurDlulldldldddrrrrUUUUruLLrdddddllURdrUUUUruLdddrUUdll
DrddlluRdrUUUUddddlllluRRRdrUUUdddrUUUddllllluurDRRllldRRRRdrUUdlUllll
uluurDldRurDldRRRR

Solution/Pushes (Built-in)
urrDDuulldlDDlUrururrddlDLrurrDLddrUdlllllUdrrURdllluRUUlluurDldRDrddl
UUUdrddrruLrdrruLLruulDrurDlddlllluurRRurDllllddrrrUdllluurrRllluluurD
DDrrrddlllUdrrruuuruulldLDlluurDldRurrurrddldddllluUUdRRlluluurDrrurrd
dlDlllUdrrrurrdLuuurDlulldlDldddrrUdrrUUUUruLLrdddddlluRdrUUUUruLddlDr
ddlluRdrUUUUddrUUddlddlllluRRRdrUUUddlllURRdrUluRdrUdlddrUUllllluluurD
rDulldRdRRRdrUlllluurDldRRRR


"YASGen 7", by Brian Damgaard

   ######
 ### ...#
 # $ #+.#
 #  $$**#
## $ $ .#
# $ #   #
#     ###
#######

<#Author#/>

Solution/Moves (Built-in)
DDLddlluUddrruuLURdddlllluRuuRldddrrruulLulDrrrddllUdrruurrdLullLddrrU
dlluurRddlllluRdrrruullulDrrruLrdddllUdlluRuRRllddrrrurruULuullDDuurrd
drddlldllluuuuRlddrUrRDLulldddrrrUrruuLDuLLdRddllluuuRldddrrruulLulDrr
rurrdLLLLuRdrruuullDDlluRdrRdddllUURurDrruLuurDlullDDRdrUUruLdddrUUdll
lulldRRRRllldddlluRdrUUddrrUULuRdrrUddLuUUdllulldRRRRllllDRRRllddrrUUl
uRdRUddldlllluRdrUUluRRR

Solution/Pushes (Built-in)
DDLddlluUddlluRdrrruuLURdddllluuuRldddrrruulLulDrrrddllUdrruulLrrrrdLu
lllddrrUdlluurRddlllluRdrrruullulDrrrddllUdlluRdrrruuuLrddrruULrddlldl
lluuRRllddrrrurruuluullDDuurrddrddlldllluuuuRlddrUrRDLulldddrrrUrruuLD
uLLdRddllluuuRldddrrruulLulDrrrddllUdrruulLrrurrddLruulldllddrrUdlluuu
RdlddrrurruuluullDDlluRddddrrurruulLLrruullDlDururrddlLrrrddlUUlluurrr
DulllddrrUruLdddrUUdlllulldRRRRddlUrrUddlldlluURRRlluRRddldlllluRdrUdr
ruuluulldRRRdrUUdllllDRRRdrUUddldlllluRdrUUluRRR


"YASGen 8", by Brian Damgaard

#######
#.... #
#*.## ###
#.* #   #
# $ $$  #
# $$  $ #
#@ #    #
#########

<#Author#/>

Solution/Moves (Built-in)
uuRUdlddrURRdrrULrruulDulDuuullllDDrrDRRurrdddllUUUrrdLulDllullDRRRRur
rdddlllUdrrruuulldLddrUdrruLUddlluRluLulldRdRRuLrddrrruulLrrddlUdlluRl
luulluurrrrDDDLdlldlUUUrrDullddrUrrruuullllDDDrrrddrrruuuLrdddllluurUr
rdLrddlULrruullDlllluuurrrrDDrrdddlllURdrruuulluulllldddrdRluluuurrrrd
dDLLuLUluRRlddrddlUUUluRddrdrrurrdLLLLdlUUUddlUUrddddlUUUrrdrrrrddlUru
LLLLdlUUrdrrrddlUruLLLrrdLLLUddlUU


"YASGen 9", by Brian Damgaard

  ########
  # *    #
### *.$  #
#   **$  #
#  $.*@###
###  .##
  #####

<#Author#/>

Solution/Moves (Built-in)
LURlLLuuRDuRRDLdddllUURDldRurrULuullDRlDRddlUUruurrDLulDrrrruLLdllDldd
rUrUdlluRuulDDruRRuLdlddrrULuurrrddLLdllUluuRRdDrrruulDrdLLLuRlulldRld
RddlUUruurRddLruulldDldlluRRRuulDrdLdlluRRururrdLrdrruLLrruLLL

Solution/Pushes (Built-in)
LURlLLuuRDuRRDLdddllUURDldRurrULuullDDRluRdddlUUruurrDLulDrrrruLLdllDl
ddrUrUdlluRuRRllulDrrruLdlddrrULuurDllluRdrddllUdrruulDldlluRRRuulDrdL
ddrUluurrruLdllddrrrUdllluurrDullddrUrrdLuuurrrddLLrruullldDlldlluRRuu
RRddrrruulDrdLLruLruLL


"YASGen 10", by Brian Damgaard

#########
#  ##   #
#. $@$  #
#.*.$# ##
#*.* #$ #
#.#   $ #
#. # $$ #
#.      #
#########

<#Author#/>

Solution/Moves (Built-in)
DDDlUlUlDrrruLdllDDrdrrUUddrrruuLUrdddlULrruulDLddllluluurruruRurrdLDD
rdddllllluluurruruRurDlldldlluRluurDRRlllddrrUdlluurDrruLrRurrdLLLdlll
dddrdrrrrruuulUdrddLUUdddlllluluuurrddRRlluurDldRluulldRluuurDDrruLrru
rrdLLLdllldddrdrrrrruuulUdrddlUUdddllURdllluluuurrrdDRluullluurDldRldd
drdrrruuluuuLrdddrddllluluuuuurDrrrurrdLLLLLulDDDDuuurrrdddrddrruuulUd
rddLUlluuururrdLLLLLulDDDuurrrdddrrUUddlluuururrdLLLLLulDDurrrrrdddddl
lUUUUddrruuulLLLulDrrrrrddddLdlUUUUddrruuulLLL

Solution/Pushes (Built-in)
DDDlUlUlDDDrdrrrrruuLUrdddllllluluurrruLdllddrdrrUUddrrULrruulDrddllll
luluurruruRurrdLDDrdddllllluluurruruRurDlldldlluRluurDRRlllddrrUdlluur
DrruLrRurrdLLLdllldddrdrrrrruuulUdrddLUUdddlllluluuurrddrRlluurDldRluu
lldRluuurDDrruLrrurrdLLLdllldddrdrrrrruuulUdrddlUUdddlllluluuurrrddRlu
ullluurDldRldddrdrrrrruuulDlluuuLrdddrrrddllllluluuuuurDrrrurrdLLLLLul
DDDDuuurrrdddrruUddlluuururrdLLLLLulDDDuurrrrrddrdddlllUUUUddrruuulLLL
ulDDurrrdddddrrUUUUddlluuururrdLLLLLulDrrrrrddddLdlUUUUddrruuulLLL


"Chaos", by Brian Damgaard

  #####
###@ .#
# $ #.#
#  $$ #
#.  # #
#   $.#
#######

<#Author#/>

In Greek mythology, Chaos was the unorganized state from which all things arose. Chaos preceded the origin not only of the world, but also of the gods.

Solution/Moves (Built-in)
dDuurrddLLrrddLLUlluuRDRddrruuLLrruullDlldddRRuULrrruullDldRddlUruuurr
ddddLLuuRlddrruUUdlldlldRRuuulDrddlluRurrrddLLUluRRlddrruUlldlldRRRllu
uulD


"Gaea", by Brian Damgaard

#######
#@.   #
#$$.$.#
#. *$.#
# $ *$#
#.    #
#######

<#Author#/>

In Greek mythology, Gaea was the goddess of Earth and the daughter of Chaos. She gave birth to Uranus, the sky, and with him, she was the mother of the giants, the Cyclops, and the 12 Titans.

Solution/Moves (Built-in)
rrdDllddrrrrUULLuullDDDuuurrddLrrrddlllUlURRuurrDDLUlullDRdddrrUULrruu
LLDlluRdrRdddlluRUdllURuulDrddrdrrULuuuLrddddlluR


"Uranus", by Brian Damgaard

#######
#+$ ..#
#$$$$*#
#.    #
# * #.#
# $  .#
#######

<#Author#/>

In Greek mythology, Uranus represented the sky or heaven. He was both the son and husband of Gaea, the Earth, by whom he fathered first the hundred-handed giants and the Cyclopes, and later the 12 Titans.

Solution/Moves (Built-in)
RRDDllUdrruulDldddRRUULrddlluRurrrddLLUluRluurDlddrdrruuULLDRlldldRRRl
UluRuulDlDurrddlUrurrDLulDlddrUluluRRRdLulDrddllU


"Cronus", by Brian Damgaard

#######
#. $..#
#.$ $.#
# $ $ #
#$$# $#
#. + .#
#######

<#Author#/>

In Greek mythology, Cronus was the youngest of the Titans, the 12 children of Uranus (Heaven) and Gaea (Earth). Cronus became supreme ruler of the universe by killing his father. With his sister and wife Rhea, he was the father of the original gods of Olympus: Hestia, Demeter, Hera, Hades, Poseidon, and Zeus.

Solution/Moves (Built-in)
rrUUULDrddllllUURRRDrdLLLUluRddrruuuuLLDDRUluRdrrDLddllUURlddrruUluulD
rdrruLdddrUdllluluRRluurDrDDrdLuuurDDluulldRRdrU


"Rhea", by Brian Damgaard

#######
# . + #
# #$*$##
# $. . #
# *$ $ #
### * .#
  #    #
  ######

<#Author#/>

In Greek mythology, Rhea was one of the 12 Titans, the daughter of Uranus and his mother Gaea, whose position as goddess of the Earth she assumed. With her brother and husband Cronus, she was the mother of the original gods of Olympus: Hestia, Demeter, Hera, Hades, Poseidon, and Zeus.

Solution/Moves (Built-in)
DDrDuluulllddRRDRUrrdddllUUddrruLruulDllulluurrrrDDLLrrrdddllUURuuulll
ldddRRRddrruLUUrDllllluuurrDDRdrruLdlLuuurrDDrdLddllURlUURDrruLuulllld
ddRRRllluuurrDDuurrddLdLUrruullllddRRURuLdddrUrrdLulldddrrUUruLdddlluR
luuuurrDDLUdDlddrUUUrrdLulDlddrrUU

Solution/Pushes (Built-in)
DDrrdddllluRdrruuulllDurrrdddlluUluRuulllddRRdrUdddrruLruuLDllulluurrr
rDDLLrrrdddllUUddrruLruulDuuullDRlulldddRRRUdllluuurrdDrrrdddllUUddrru
LruulDlLuuurrDDrdddlllUUrRurDluuulllldddRRRllluuurrdDuurrddLruulldRddL
UruulllddRRUruLdddrUrrdLulldddrrUUruLdddlluuuuurrDDuullddddRluuuurrddL
UdDlddrUUUrrdLulDlddrrUU


"Oceanus", by Brian Damgaard

########
# .  . #
#. $*$.#
# #  $ #
#.  $# #
#.$# $*#
#    $+#
########

<#Author#/>

In Greek mythology, Oceanus was one of the Titans, the 12 offspring of Uranus (Heaven) and his mother Gaea (Earth). Oceanus ruled over Ocean, the stream surrounding the world. With his sister and wife Tethys, he was the father of the ocean nymphs, also known as the three-thousand Oceanids.

Solution/Moves (Built-in)
UUULLDllluururrDLulldddrrrUrrdddLLUUllluuurrdDuurrrDDlLUdrruulDlddddrr
uUULullulldddddrRRRluuUruuLLdRdrrddLdlllluuuuRRurrrDDllUlllddddrrrUUUr
ruulDLLuRdddddllluurRUruulDrdDllluuuRldddrrruulLulDrrruLrdrruLdlddllld
drrrrurUULullllDDrrrUrrddldlllUdrrUUlLrrdrruuluLLLrDurrdrddlluUruurDDD
ullluuRldRRdldddlluuRlddrruUU


"Tethys", by Brian Damgaard

#########
#@$  . .#
#**$$ * #
# $...* #
#. *$$  #
## *    #
 ########

<#Author#/>

In Greek mythology, Tethys was one of the Titans, the 12 offspring of Uranus (Heaven) and his mother Gaea (Earth). With her brother and husband Oceanus, she was the mother of the ocean nymphs, also known as the three-thousand Oceanids.

Solution/Moves (Built-in)
RRRRRlllllDDRRlddRRRUUUdddllluurRllddrUdrruLrrruuLDuuLLDDRddllluuRRuur
rdrdddLLLUUllddRluurrdLrrdrruuulullDDuurrdLDllddRRULullluurDuRRDLrrrrd
dLLUddllUURuulllddRRddrrurruuluLLLDDlluuRlddrruLrrurrdrddlldllUUddrruL
rrruulDuulldDRluurrdLdllluuRRDrdddlllUUrRuulDrrrrddLUrddLLLURdrU

Solution/Pushes (Built-in)
RRRRRlllllDDRRlddRRRUUUddrruuLDlddllluurRllluurrrDRDLuulllddrddrrUdllu
uluurrrdrdrrddLUdLLuRuululllddrddRluuluurrrdrddlLrruulDuulllddrRlluurD
urrdrdddrruuuLuLDlLuRlddddRRuLUluurDrrrddLLUddllUURuulllddRRddrrurruul
uLLLDDlluuRlddrruLrrurrdrddlldllUUddrruLrrruulDuulldDRluurrdLdllluuRRD
rdddlllUUrRurrrdddLLuUluulDrRdddrruLdlUdLU


"Mnemosyne", by Brian Damgaard

########
# . # @#
#  $ $$#
#.*. $ #
# .$ $.#
#$* ## #
# .  . #
########

<#Author#/>

In Greek mythology, Mnemosyne was one of the Titans, the 12 offspring of Uranus (Heaven) and his mother Gaea (Earth). Mnemosyne was the goddess of memory. With Zeus, she was the mother of the 9 Muses.

Solution/Moves (Built-in)
DDLLrruulDlddLddrrruUULulLDDrUrrdddlllllUUURRRllldddrrUUruLuullDRlDDRU
rrdLddllURdrrrruuLLullDDldRuuurrdrruLuurDDldlLuRllluurrDullddrRdrrULLu
ullddDRddlUUrRuuulldRDDlUrrrrdLLulldddrRRlUUruLdddlluuRDuRurrdLLdlluuR
RluurDlulDrdDrrruruulDLLrDurrdLdLLUlURRlddrruLLrrruulDrdLL

Solution/Pushes (Built-in)
DDLLrruulDlddLddrrruUULulLDDrUrrdddlllllUUURRRllldddrrUUddlluRluurDldd
rrrrruuLLuLuullDRlDDrUrrdrrddlllllUdrrrrruullulldDldRRRlluuurrdrruLuur
DDldlLuRdrUlllluurrDullddrRdrruLLuullddDRddlUUrRuuulldRDDlUrrrrdLLuluu
rDldRdrruruulDLLddrUllldddrrUUddlluuurRuullDurrddlUrddrrULLdddlluuRDuR
uulDDrurrdLLrruruulDrdLLLuRdrruulDrdLL


"Coeus", by Brian Damgaard

 ######
 # .  #
##$#. ###
#@* .   #
##$#**  #
# $  .###
# $ $ #
#   .##
######

<#Author#/>

In Greek mythology, Coeus was one of the Titans, the 12 offspring of Uranus (Heaven) and his mother Gaea (Earth). With his sister and wife Phoebe, he was the father of Leto and Asteria.

Solution/Moves (Built-in)
RRRDRddLUddllluuRRDullddrRurruLLrruUlDrurrdLLuluurDldRdddlluRdldlluuRR
drrUUUlllDurrrdrruLLLuurDldRdddlluRdrUUUlDDuuuullDDRluurrdDrddllddlluR
luRUUrrrdrruLLLuurDldRddlUUruulllDDDDRllddrrUdlluuruuuurrrdddddLUruuuu
lllddddRRdrUllluuuurrrddlUruLddDDlluuRlddrruUddlllddrrUdlluuruurrddrdL
uuurDlullddRllddrrUrUUruLLrrdrruLLdlddldlluRuRlddrUrUdrUdllluRR


"Phoebe", by Brian Damgaard

########
# . .$+#
#  $*$*#
# . #  #
#.#$$ $#
#    $ #
#.  # .#
########

<#Author#/>

In Greek mythology, Phoebe was one of the Titans, the 12 offspring of Uranus (Heaven) and his mother Gaea (Earth). With her brother and husband Coeus, she was the mother of Leto and Asteria.

Solution/Moves (Built-in)
LDDrDDLLLLrrrruulDrdLuuuurDDlddLLdllUUUrrDRdrUllulldddrrUdlluRRlluuruu
lDDrrDrrUruulLLDurrrddlULLrrddllUlluuRDRRuLdlldDDrdrUUUddlluuRuRDDrrur
uuLDLLddrrdrUUdlllullddrdrUlluurrurrDrdLuuurDDlulluRdrdddLLUUlluuRDRRu
LdlldddRdrUUULulDrrddrruuruuLDlLuRdldlluuRDrruLrdrruLdllddRdrrUUddlluR
UrULdddrUU

Solution/Pushes (Built-in)
LDDrDDLLLLrrrruulDrdLuuuurDDlddLLdllUUUrrDRdrUllulldddrrUdlluRRlluuruu
lDDrrDrrUruulLLDurrrddlULLrrddllUlluuRDRRuLdlldDDrdrUUUddlluuRlddrrurr
uruuLDlLDDrrdrUUdllluurrDrdLuuurDDlulluRdldllddrdrUlluurrurrdddLLUUllu
uRDRRuLdlldddRdrUUULulDrrddrruuruuLDlLuRdldlluuRDrruLdrrruLdlldddrruUd
drUUULdddlluRRdrUU


"Hyperion", by Brian Damgaard

########
#. .*  #
# $ *  #
## .$ *#
## $ ..#
#@$$**$#
#  .   #
########

<#Author#/>

In Greek mythology, Hyperion was one of the Titans, the 12 offspring of Uranus (Heaven) and his mother Gaea (Earth). With his sister and wife Theia, he was the father of Helios, god of the sun, Selene, goddess of the moon, and Eos, goddess of the dawn.

Solution/Moves (Built-in)
drUdrrULUURDrrULdllddrUdrrULuuuuLLDRlDDRUrrDLulluurrrDulllddrrdddllURd
llluRdrruUruULDllDDRUddrrUULuuulLDDRUrrruLdlldDrrrUdllluurrDrdLddllUlU
drdrrrUluuulldDRluurrdLdlldldRRRUrrdLuULuurDrDLddrUllLdlluRdrRuUruulll
DDRRddlUdlluRuRlddrrurrdLulLuluurrrdrDululllddrdrrULdldlluRuuurrDDrruL
ulllddRRUruLrdrdLddrUdlLLUluuRRururDlDDullluRdlddldRurUR


"Theia", by Brian Damgaard

########
#@$  . #
#$$** .#
#.   $ #
#.$**$.#
#  .$ $#
#. *.  #
########

<#Author#/>

In Greek mythology, Theia was one of the Titans, the 12 offspring of Uranus (Heaven) and his mother Gaea (Earth). With her brother and husband Hyperion, she was the mother of Helios, god of the sun, Selene, goddess of the moon, and Eos, goddess of the dawn.

Solution/Pushes (Built-in)
DDDDrrRdrrUUULLDDuurrdLuuurDlddrddlUlllluurRRDulllddrrUruLddlluuuuRRRD
rrDDLdLLrruUddlluuRuulllddRRddrruruuuLLLDDllddRRlluuuuRlddrruLdlddrrUL
uurrurrdddldLruruuulldllddrRdrdrUUUddllulluuulDrrruLdlddrrUddrruuLDlll
uururrDDrdLLrrddlUruuluulldldddRRlluuurRlldddrruUrrdLrddlUllluuururrrD
DDuuulDulldRlldddrrUULuurrrdddLruuullldlDruurrrdddldllUUddrruruuullDur
rdddldlluululuRRRdLdddrruruuLLulDDuulldRurrdrrddlUddlllUUrRuulDulldRdd
drrruruuLrddlUddllluuRRDrdLruruuuLLDDRluurrdLddrUdlddrUluullluuRR


"Iapetus", by Brian Damgaard

########
# $   +#
#  $ #*#
#  $ # #
# *$$  #
#**.#  #
# .. . #
########

<#Author#/>

In Greek mythology, Iapetus was one of the Titans, the 12 offspring of Uranus (Heaven) and his mother Gaea (Earth). With the nymph Clymene, he was the father of Prometheus, Atlas, Epimetheus, and Menoetius and an ancestor of the human species. His wife was occasionally considered to be Asia or Asopis.

Solution/Moves (Built-in)
llddLDRuuulDlluRdrrddlUruurrDDDLddllllUUURRlldddrrUUddlluRluuruulDrdDl
ddrrrruuLULrdrruuullLDllDDrUdRRuLuurrrdddLddllUUUdddrruuLulDlluRdrrrdd
llllUdrrrruulllDldRuuulDrrrrruuullDDLdRuuulDrddllluuRRurDlllddrddlUruU
luuRDrrurrdddLLLUdrrddlLUllUURDRddrruuLrruuulldDLDlluRuulDrddrRuuuLrdd
dlluuRurDllluRdddlUrurrurrdddLLLUluuRRdLdlldddRRUUrULuullDDDRDrUlluuRD
DrrrruuuLLDDuurrdddlddrUUUdlLLddRluuruuLDDDuulluRuRRRllDDD

Solution/Pushes (Built-in)
llddLDRuuulDlluRdrrddlUruurrDDDLddllllUUURRlldddrrUUddlluRluurDlddrrrr
uuLUdrddlllluuruuulDrddlddrrrruuluLrdrruuullLDllDDrRRllUdrruLuurrrdddL
ddllUUUdddrruuLulDlluRdrrrddllllUdrrrruulllDldRuuulDrrruLrdrruuullDDld
RuuulDrddllluuRRurrrdddLruuullDllluRdlddrddlUruUluurDrrurrdddlddlLrruu
LLUdrrddllUllUURDuuulDrddRddrruuLULDllddRRlluurrrrruuullDuLDlluRdrrurr
dddlllllUdrrrrruuulldllDurrurrdddlllUluuRRdLddrUllldddrrUUruLuullDDDRD
uluuurrddrdLuuullddRDrrrruuuLLDDuurrdddlLLrrddrUlullddRluuruulDDDuulld
RurDlluuurDDrrdrdrUUdllluluuRRR


"Crius", by Brian Damgaard

########
#@*    #
#$ **$ #
#.$ .  #
# $.$#$#
# *.  .#
#  .*  #
########

<#Author#/>

In Greek mythology, Crius was one of the Titans, the 12 offspring of Uranus (Heaven) and his mother Gaea (Earth). With Eurybia, he was the father of Pallas.

Solution/Pushes (Built-in)
DDDRUrrDLddRluuulluuRRRDulllddrrdddllUdrruuulluurDurrdLddddlluRlUURDrr
ULdllddrrrUdllluurrDullddrUruuuullDDDRluuRlddrddlUrrrdLuluUrrDLrurruuL
DuLLDRddlddrUllldRurrrrUUddllluUllDRdrrrruuLLLruulDrdrrddlllluluuRRurr
DulldlluRdlddrddlUrrrdLuluUluurDrRdDLdllUUddrruUddlluuRDuuulDrddrruuuL
rdddlddrUlullddRluuruuRDldlddrUrrrruuLLLDuullDDRdRRlldlUrrrdLuluUrrDLu
uurDldlluuRDrdddllUURDuuulDrrruLdlddrrULdddrUlullddRluurrurrrdddLruLLU
luuurrrDDDulLrruulDulldlluRdrRddlllUdrrruullDurrddlUlldRuuulDrdrruuLrr
rdLrdL


"Themis", by Brian Damgaard

########
#@$  . #
#** * $#
# $*. .#
# $ $  #
# #. # #
#  .$. #
########

<#Author#/>

In Greek mythology, Themis was one of the Titans, the 12 offspring of Uranus (Heaven) and his mother Gaea (Earth). She was the goddess of divine justice and law. With Zeus, she was the mother of the Seasons and the three Fates.

Solution/Moves (Built-in)
DRlDDRURRDrruLuurDlddlLuRllluuRDuRRDrruLdlLddrUdrrULuurDlddlluuuRldddr
ruuLulDrrruLdddrUlullulldddRRRUruuLLdRddllluuRRllddrUdrrurrdLulLuurDld
dlluRluuRDrrurrDLddLLURdlddllUUURuuRRDrruLdlLDDrUdrrULuurDlddlluuuRldd
drruuLrddllulldRurRuulDrrruLdllullDRddlddrrRUUULrdrrULuuLLDRlllDDrUdRR
UrrdLulLuurDurrDLddrUluulldddRluuurrddLdlUrrrdLuuurDldlldlluuuRRRDrddL
LuRuulllddRRlluurDurrdrruLdlLddrUdddlllUURRurDrrddLLLUdrrruullDldRuuul
DrrrULuurDlddlluuuRldddllURdlddR


"Hestia", by Brian Damgaard

########
#    . #
#$#$.$ #
# $ #*.#
# *  $ #
#.* .* #
#@$  . #
########

<#Author#/>

In Greek mythology, Hestia was the goddess of the hearth. She was the eldest daughter of the Titans Cronus and Rhea, and sister to Zeus, Hera, Hades, Poseidon, and Demeter.

Solution/Pushes (Built-in)
uRRdrrruuuuLrddLUrdddlUdllulldRurRdrruuuuulllDDDuuullDDDRddRRuLUlluuur
rrrrddddLLdllUdrruLrrruulDruuullldDDRddlllUURRuuurrrddddLruulDrddLLLUU
RRllddrUdrruLuuruullldDDRlllddRRRUrrUUlDLddllluurRuuurrDDrdddLLLUUlldd
RUrrdrruuuluulldDDuuulldDDRddRRuLUlluuurrrrddrddLruuluulllldddrrUURurr
DLdDrUluulLdddRlddrUluuuurrddrddLLdlUrrruuluurDldDrddLUUdlldRluUlluuuR
RRldDDRddlllUUrrrdrrdLLuulllddrURRluuuulldDRluurrdDDrddLUllUUrrDullddr
RuulDrddrrruuLLLulldddRRRluuuuullDDD


"Zeus", by Brian Damgaard

########
#@.$ *.#
#$$. $ #
#.# $ *#
# $. ..#
#. *$$ #
#  $.  #
########

<#Author#/>

In Greek mythology, Zeus was the ultimate ruler of heaven and earth and of all gods and humankind. He was the youngest son of the Titans Cronus and Rhea. He was married to his sister Hera, but had, however, many casual affairs with mortal women as well as goddesses, and he fathered innumerable children.

Solution/Pushes (Built-in)
DDDRddRRULUURuuLDrdDllluuRRurDlllddrrrrrUULLLrrrddlllUdrrruullDurrddlU
lldRuuulDrddllluuRRDrdLddrUluurrrddLLUdrruulDlluRluurDlddrrruuLLulDlld
dRRRUdllluurrDrdddlllUUrRurDluuurDrrddLUrdddLLLrrUdllUUURlddRlullddRUr
rdLuuurDlddrrruuLLrrddlUdlluRllldRurruulDrddrruuuLrddLruulDlluRuulDllD
DRddRRUUUdddlluuRlluurrDrDLuuurDlddrrruuLLDurrddlUlldRuuulDllddRddrrUU
UdddlluuRlluurrDrrrdddLLuURurDllLuRluurDlddrrruuLLulDlluRdlddRRRddrrUd
lluuURuLLLulDrrruLrdddlUrdddrruLUlllddRRUrrdLuuLuurD


"Hera", by Brian Damgaard

#########
#.$.  *@#
#  .$*$$#
## $* * #
#   *   #
# #$.$#.#
#.$ .  .#
#########

<#Author#/>

In Greek mythology, Hera was queen of the Olympian gods, the goddess of marriage and the protector of married women. She was the daughter of the Titans Cronus and Rhea and was married to her brother Zeus.

Solution/Pushes (Built-in)
LLDLLDldlddRRRRRllllluurururrDulldRlldlddrrruURlLuuuLDrrruLdlddrrULuur
rrDDLLrruulDulldRllluRdrrddlUruurrddDLruuullddldddllluuRUdlddrrruuuruu
rrdLrddlUlldddllluuruRuuRRDLDDRUllldRuruullDRdrrrruuLLLDurrDulldRllddl
lddrrrrUUULrdddlllluurrRurDluuurDllluRdrddllURurrurrdddLLLUluuRRdLddrr
ruuLLDldRlulldRurruulllDurrDulldRddllddrrrrUULLuuurrdrrddLLddllUUUdddl
luuRlddrrrruurruullullldDrDRRddlllluuRuuurrrdDDuurrddLruulldLrurrddlUl
ldRuuullldddlddrrrrUdlllluuruuurrrddldDuuruullldddRllddrrUrrUUlDLddllu
uRuuurrDDrddLruulDrddLLrruuluuulldRlddRUrrdddllUUluuurrDulldddrddrruuu
rruuLDuLLdRddddlluuRDldLruuluuRRDuurrrddLLrruulDulldRlllddrdrrUUddlluU
ddrruuLuurrrddLLddlluluuuRRRDDrruuLDllulldddrdrrUUddlluluuRlddrUddrruu
LDlluuurrRDrrddLLLrrUdlluRuulllddRRdrUllldRurrdrruuuLLLDurrrdddlluUluR
dddrruuL
